AJ Smith	Ajs 	Other
CEL Gas Services Ltd	cel	Other
Colum Jordan	col	Other
DHB Utilities Ltd	dhb	Other
DPF Gas Ltd	dpf	Other
Durham Utilities	dur	Other
Forefront Contracting	for	Other
Gas Tech Utilities	gas	Other
Gasco Utilities	Gas	Other
GPO Construction Ltd	gpo	Other
JM Utilities	jmu	Other
K S Pipe Contractors	ksp	Other
KLT Construction	klt	Other
Multi Utility & Surfacing Ltd	mul	Other
Murray Utilities Ltd	mur	Other
Nigel Wilson	nig	Other
RD Utilities	rdu	Other
RWB Utiltities	rwb	Other
Sam Taylor Utility Services	sam	Other
SAUK Utilities	sau	Other
tRIIO Morrison	tri	Other
tRIIO Skanska	tri	Other